rrrrrrrrrrrrrrrrrrrr
r..................r
r..................r
r..................r
r..................r
r..................r
r........OYR.......r
r...e..........e...r
r...RBG...P...BGO..r
r..e...............r
rrbbggooyyrbgoyrbgoy