....................
....................
....................
....................
....................
....................
.........OYR........
....................
....RBG...P...BGO...
....................
rrbbggooyyrbgoyrbgoy