rrrrrrrrrrrrrrrrrrrr
r..................r
r..................r
r..................r
r..................r
r....c....c........r
r........OYR.......r
r...ec.........e...r
r...RBG...P...BGO..r
r..e...c.......c...r
rrbbggooyyrbgoyrbgoy