rrrrrrrrrrrrrrrrrrrr
r..................r
r..................r
r..................r
r..................r
r..................r
r........OYR.......r
r..................r
r...RBG...P...BGO..r
r..................r
rrbbggooyyrbgoyrbgoy