....................
....................
....................
....................
....................
....................
.........OYR........
....................
....RBG...P...BGO..r
..................rr
rrbbggooyyrbgoyrbgoy