rrrrrrrrrrrrrrrrrrrr
r..................r
r..................r
r..................r
r..................r
r..................r
r........OYR.......r
r..............e...r
r...RBG...P...BGO..r
r..................r
rrbbggooyyrbgoyrbgoy